without the overhead - без накладных расходов
retrieve - извлекать
apparently - по всей видимости
rather than - скорее чем
Typically - как правило
regardless of the - независимо
represented - представленный
interrelated - взаимосвязаны
relevant - актуальный
relatively - относительно
longstanding - многолетняя
decade - десятилетие
Conversely - наоборот
surround - окружать
crucial - ключевой, критическийЮ решающий
depth - глубина
leverages - рычаги, системы рычагов
superior - превосходная
to expose - разоблачать
entity - сущность, объект
augment - увеличивать, дополнять, прибавлять
accurate - точный, тщательный
beforehand - заранее
root - корень
indicates a deeper problem - указывает на более глубокую проблему
forgery - подделка
transmit - передавать
vendor - продавец
comprehensive facilities - комплексные (сложные, всеобъемлющие) возможности (удобства, оборудование)
proprietary - патентованный (частный)
comprises of a non-exhaustive - состоиз из не исчерпывающего
concept - концепция
reflect - отражать
debt - долг
arise - возникать
handle - справляться, обращаться, управлять
to inject - вводить, впрыскивать
curriculum - учебный план
vital - жизненно важный
I wish all of you - я желаю вам всем
Treat your work and code the way you want others to treat you - 
Относитесь к своей работе и кодируйте так, как вы хотите, чтобы относились к вам другие
avenue - проспект
sustainable - устойчивый
evaluation - оценка
urgent - срочный
escalations - увеличение машстабов, эскалация
to stuck - застрять
Hygienic - гигиенический
viable - жизнеспособный
expedite - ускорять
comparison - сравнение
align - выравнивать
accountability - учитываемость, ответственность
stakeholders - заинтересованные стороны
to harness - использовать
in recent years - в последние годы
to figure out - выяснить, понять
accommodate - вмещать, приспосабливать
transparency - прозрачность
absent(to absent) - нет на месте, отсутстствующий
to summon - вызывать, призывать
substitute - заменить, замещать
denote - обозначать
intervene - вмешиваться
sketch - эскиз, набросок
thoroughly - тщательно
elaborated - тщательно разработанный
reveal - показывать, раскрывать
presence - присутствие, наличие
reflects a state - отражает состояние
incorporated - включенный в
eventually - в конечном итоге
get rid of - избавляться от
it aligns - это совмещается
Of the mentioned ones - из упомянутых
as ongoing - как продолжающиеся (постоянные)
it is advisable - желаельно
pitfalls - подводные камни
inevitable - неизбежный
frustration - разочарование
consuming - потребляющий
complicate - усложнять
flawless - безупречный
indentations - углубления
redundancy - избыточность
robust - крепкий, здравый
nevertheless - тем не менее, однако
eliminating - уничтожение
detrimental - вредный, убыточный
oversights - оплошность, просчеты, недочеты
pipeline - источник информации
mutual - взаимное
clarity - ясность
convention - условность
layout - расположение
indentation - отступ, вдавливание
trail - след
to reveal - раскрыть
constantly - постоянно
borrowed - заимствованные (to borrow - занимать)
capability - возможность
fortify - укреплять
immensely - безмерно, очень
enhances - усиливает
perceptive - восприимчивый
pressure - давление
flaw - изъян, недостаток
buffer overflow - переполнение буфера
to spot - заметить
snippet - отрывок, кусок
implications - последствия
angle - угол
severity - строгость, суровость
assess - оценить
Containment - политика сдерживания
exploratory - разведочный, исследовательский, предварительный
throughout - на протяжении
rushing - торопясь, бросаясь
resilience - упругость, эластичность
compatibility - совместимость
tangible - ощутимый, осязаемый
not to mention the fact - не говоря уже о том..
data flows - потоки данных
diversity - разнообразие
versatile - разносторонний
considerations - соображения, рассмотрения
scope - объем
lack - отсутствие , недостаток
thoroughly - тщательно
adjust - регулировать, приспосабливать
threshold - порог, предел
it's worth mentioning that - стоит отметить, что
pick up - Забирают, подбирают, принимают
scalable - масштабируемый
engagement - обязательство, помолвка
disparity - несоответствие
compose - составить, сочинять
unified - единый, унифицированный
allocation - распределение
mapping - отображение, преобразование, картография
emphasis - акцент, особое внимание, ударение
advent - пришествие, наступление
bear in mind - иметь в виду
note that - обратите внимание, что
to cater - угождать
ahead - впереди
most likely - скорее всего
compatible - совместимый
concurrency - совпадение
to omit - пропускать, пренебрегать
(to) gather - сбор, собирать
node - узел
loop - петля, виток, цикл
evenly - равномерно
lightweight - легкий, несерьезный
harness - использует
timescale - временные рамки
sustainable - устойчивый
to maintain a constant pace indefinitely - поддерживать постоянный темп на неопр. срок
emerge - появляются, возникают
adjust - регулировать, приспосабливать
tune - настраивать
accomodate - разместить
refine - усовершенствовать
will come to light - выйдут на свет
trade-offs - уступки
solid - твердый, прочный
neglected - запущенный, пренебреженный
overall timeline - общий график
commitment - обязательство
definitive - окончательный, точный
in succession - подряд
Once an idea is deemed viable and feasible - когда идея считается жизнеспособной и осуществимой
quantifiable - количественный
funding - финансирование
lays down the foundation - закладывает основу
assuming simplicity and embracing change - предполагая простоту и охватывая изменения
blends - смешивает
speculate - размышлять
It addresses the common failures - он решает общие проблемы
lack - недостаток, отсутствие
never compromise quality - никогда не ставьте под угрозу качество
lean - бедная, скудная
amplify - усилить, увеличить
empower - уполномочить, дать возможность
make policies explicit - делайте политику явной, точной
reflective improvement - улучшение рефлексии
osmotic - осмотический ?
co-located - совмещен
supplement - дополнение
division - деление, разделение
mentor - наставник
takes it one step further - делает еще один шаг вперед
scale - масштаб
trademark - товарный знак
adopt - принять
tackles tough issues - решает сложные вопросы
emphasis - акцент
turnover - оборот
realities you observe - реалии, которые вы наблюдаете
Without in-depth, upfront planning - без глубокого предварительного планирования
burndown chart - график выгрузки
burndown rate - скорость(ставка) выгорания
Multiply - умножить
Planning poker is a consensus-based, gamified technique - основанный на согласии, игровой метод
